#####################
###.####.####.####.##
##..........#......##
##.####.###.######.##
##.#....#.#......#.##
##.#.####.######.#.##
##.#.#.........#.#.##
##.#.#.#######.#.#.##
#..#.#.#.....#.#.#.##
#.##.#.#.###.#.#.#.##
#..#.#.#..S#.#.#.#.##
##.#.#.#####.#.#.#.##
##.#.#.......#.#.#.##
##.#.#########.#.#.##
##.#...........#.#.##
##.#############.#.##
##...............#.##
###########.######.##
##.................##
###.#.###E###.###.###
#####################