############.#################
S...#....#...#.....#....#....#
###.#.#.##.#.#.###.#.##...#.##
#...#.#....#...........#.#..##
#.###.#.#.#..#########.#.##.##
#.......#.##.#.#....##.#...###
#####.#.##.#.#.##.#....#######
#.....#......#....#.#.#.#.#.##
#.##########.######.#.......##
##...###........###.####.#.#.#
####.....######.###.....##.#.#
#########.......#######.#..#.#
#....####.#.#.#.####....##...#
#.#.##..#.#.#.#......#########
#.#..#.##.#...#.###.##.......#
#..#.#.##.#########....#####.#
##.#....#.........#####......#
#..##.#.#.##..###....#####.#.#
#.##....#..#####.###.......###
#...###.###....#####.#.##.#.##
#.###.##....###......#....#..#
#........#.#..#.###.#.#.#...##
#.##.###.###.##.#.#.#.#.######
#........#......#.#...#......#
##.#######.###.##.###..###.#.#
#....#.....#......#.#.#......#
####.#.####.###.#...#.######.#
#......#......#.####.#.......#
#.###.#..####........#######.#
#E############################