#######
#S....#
#.#.###
#.#...#
#.#.###
#...E.#
#######