##########
#S#.....##
#.#.###.##
#.#.....##
#..###..##
##.......#
#####.####
#......E##
#..##....#
##########