#####################################################
#....................#....................#.....##.##
#.############.#####.#.#########.#####.#####.#..###.#
#.#.........#.....#.#.#.........#...#.#.....#..###..#
#.#.#####.###.###.#.#.###.#####.#.###.#.###.#..######
#.#.#...#.#.#.#...#...#...#...#.#.###.#...#..#.###.##
###.#.###.#.#.#.###.#.#.###.#.#.#.###.###.#..##.###.#
#.#.#...#.#.#...#...#.#...#.#.#.#.......#..##..#.####
#.#.###.#.#.#####.#.#####.###.#####.#####.#..#....###
###.#.....#.#.....#...#.......#...#.....#..###.##.###
#.#.###.#####.#####.#####.###.###.###.#.#..#...##.###
#...#.#...#...#...#.....#..#...#..#...#..###.###..###
#.#.#.#.#.###.###.#.#.###.###.###.#.###.#..#....#...#
#.#.#...#.....#...#.#...#.#.#######...#.#..###.#.##.#
###.###.####.######..#.###.#####.###.#.#.##.##.##...#
#.#...#...#.....#...#.#.###.#..#.#..#..#.#..###.#.###
#.#.#.#.##.###.#..####.#.#...#..###.#####.#..##.#...#
#.#..#..#.#.#.#.#..#.#.#####..#...###.###.#..#....#.#
###.#.#.#.#.#.###..###..##.#..#.#.###.##.###.#.#.#..#
#.#.#.#.#.##..#...##..###..##.###..#.#.##.#..#.#..###
#.#.###.#..###.##...#..##.##.#...#..###.#.#.##...#..#
#.#..#..#.#.#...#.#..#..#..#.#.#..#..#.#..#..######.#
#.#.###.###...#.##..###..###..#.####.#..#..#.#......#
#.#.#...#..###..#..#..S#..#..#..##..###..###.###.##.#
###.####..###.#..#....#.#######..##.##.###..#..#....#
#.#.#..#...###..#..#..#.##..###.##.####.#..#..#.##.##
#.#.###..###.#..##..###.##.#.#..#...#.#..#.##.#....##
#.#...#.###..###.#..##.#######..##..#.##..###.###..##
#.#.##..##.#..#.#.#..#.#..###.#..#..##..###..#.#.#.##
###.#.#..##..##..#..##..#..#..#..##.##..#..###.#...##
#.#..##.###.#..###..###.###..###..###..#..#..##.#.#.#
#.#.#.#..#..##..#..#..###..###..###.##.###..##.##...#
#.#..#..##..#.#..##..###..##.##.####..##..##..#.#.###
#.#..#.#.#..###..##..#.#..#.#.##.#.##..###..###.#...#
#.#..#..#.###..##.###..#..#..#..##..###..#..#.##.##.#
#..#..##..###..#..###..##..#..#.#..##.##.##.##..#.#.#
#...#..###..###..###..##..##..#..##..##..##..###..###
#.#..#..###.....###..##..###..##.#..#..##..##..##..##
#.#.#.#.##..##..#..#..#.#..#.#..#..#..#.##..##..##..#
#.#..##....##.#.#..##.##..###..###..###..#..#.#..#.##
#.#.#.#..##..##...#..###.#..###.###..###..##..##.#..#
#.#..#..##..###.#.#.#..#..##..#..#..#.#.#.##..#.##.##
#.#..##..#..#.###..###.#..#..###.#.##..##..###.#..###
#.#.##.###..#.....##..#..###.###.###..#..#.###.#..###
#.#.###..##.###.###.#######.##..###..##..###..###.###
#.#..#..##.##...##..###.###.#.#.#..##..###.##.##.####
#.#.#..###..##..#..##...#..##..###.##.###..#..#.##.##
#.#.##.#.##..##..###..#.#..#.#......###.#.#.#..###.##
#.#.#.#.###.#.##..##..#.##..#..###..#..##..#.##..##.#
#.#.#..##..###..#....#...#.#..###..##..##.#.#..#..###
#.#.#..##..##..#.#.#.###.##..#.#.#...#..##..##.##.##.
#.#.##.###..##..###.##.#.#...#..##..#.E#.###..#..#.#.
#..##..#..##..#..#.#..##...#.#..##.....##..#.##..###.
#####################################################